1111111111111111111111111111111
1111111111111110C11111111111111
111111111111111W0W001111111W0C1
1111111111111100W00000000000W11
11111111111110000W00000000W0001
11111111111100000000000W0000001
1C00W000111100W00000W0000000011
100000W000000W0W00W0000000W0111
1W0W0000W000W0C0W00000000W01111
110000000000001100W011111000E11
11000W0000W000110W0001111111111
1100000000001111100011111111111
1110W00110001111111111111111111
1110000111111111111111111111111
1111100111111111111111111111111
1111000111111111111111111111111
1111P00111111111111111111111111
1111111111111111111111111111111
