1111111111
1PCE0000W1
100000W001
1W00000001
1111111111
