1111111111
1000P1OC11
10W0000001
10000W0001
11110001E1
1111111111
