1111111
1CP10E1
100Z0W1
1111111
