11111111111111111111111111111111111111111111111111111111111111
10000000000000000000000000000000000000000000000000000000000001
10000000011111100000000110001110000011001111110011111000000001
1000000111C0001100111C011000011000001100100000011C001100000001
100000001100001100000001100W0110010011000111100000001100000001
10000000110W001100111C011C0001101C10110W00C11000W0001100000001
10000000110000110000000111000111000111000011100000001100000001
100000000000000000000000000Z0000000000000000000000000000000001
10000000000000000000000000000000000000000000000000000000000001
10111000111100111000011000011111100011111100111110001110001101
10011001C1100001100W01100111C00011001C0000W000001100C110W01101
10011C10011000011110011000110000110001111001110011000110001101
10011100011000011C11C11000110W001100000110011E0011000110001101
10011000011000111000111000110000110000111000111110000011111101
10000000000000000000000000000000000000000000000000000000000001
1000W0000000000000001110000000000000W0000000000000000W00000001
10000000X00000000000011000000000000000000000000000000000000001
10000000000000000000000000000000000000000000Y00000000000000001
1000000000000000000C11000000W000000000000000000000000000000001
10000000001110000000000000000000000000000000000000000000000001
1000W00000C1100111001100011111110000111110000111110000W0000001
100000000001100C1100110011000001100110001100110001100000000001
1000000000011000110W110011011001100CC0001100CC0001100000000001
10000000000110001100110011C0100110000000110000W001100000000001
1000W0000001100001111000011100011000P0001100000011100000000001
10000000000W00000000000000000000000000000000000000000000W00001
11111111111111111111111111111111111111111111111111111111111111
