1111111111111111111111111111111111
1E000W000000X00C00000C00000000W001
1010010100100000101001000Y00010101
1010010010101010001001000000010101
1P0000000C00C0000000W0000Z000000C1
1111111111111111111111111111111111
