1111111111111111111111111
1P010001000000W00000C1111
100C00000111000001000C111
1101110000011000110000C11
1000100W000000001100W00C1
1000100000011000111000001
1000100001000000011100001
1W000C001100C00C001110001
1110000110000000W01111001
10011101000C00100000000C1
10000W00000000Y00C0001111
10C00111111000100000111C1
100000011100000000111C001
10011111100W0111000000001
1000W00000000000000W00001
111100C001110001011100001
1X0000000111000100000Z111
10011100011100110001CC001
1000000100W001100001000E1
1111111111111111111111111
