1111111111111
1W010000000C1
1000011111W01
1P0011E000001
1111111111111
