111111111111111111111111111111111
111111110011111111111111111111111
111111111111111111111111111111111
100001111001111000001111110000011
110001001001111111100111111110011
111001001001111001100110011110011
1110010010E1110011100111001110011
111P00000C11110000001111100000011
111111111111111111111111111111111
