1111111111111111111111111111111111111
1111111100111111111111111111111111111
1111111111111111111111111111111111111
100G011110011111100000111111110000011
1100010010011111111110011111111110011
1110010010011111100110011110011110011
1110010010011111001110011111001110011
111P00000E111111C00000011111100000011
1111111111111111111111111111111111111
